The Happy Hour
################################
# o @##         # @#@     ##@! #
# -! #  #  o  ! #|x#  ### #@<< #
#  D    ! ##@@#    #<  ##     @#
##    ### ##o##x       ##### ###
#@   o# #  #######o###o#####   #
##@ ### #      @@###|#####!#@# #
##########  ||<###@|<<@#|<@##! #
#x#o#o#o#  #x  |#@#   ##    #- #
#########< #@@#<     ##@@#     #
#x1#E###|  #x@#  #  |<#### ##|<#
########|  # ##< # !<#! !# #@|<#
#MMMS###|        #@<|#! @# ##@|#
########  #!   #######!< # #####
########@#-!     #####@  # #+! #
##@--@#####- @<# #@        ##- #
#@@###x   #@#### #   ! ## @#   #
# ##@## # ###    #   ##o# !# # #
#  #@#  #     #### ##  -# @# ! #
#@ #   ##   ###@@#        ## ! #
## ###|<##  @##### D2! #@    #-#
#@   #@#@#   #@@@@   ! ##### ! #
#x !< ##@##  ############  ##! #
#@ -|@@#! #   ###@@  !<#   ### #
########- ##<   ###+ !   #  ## #
#x####### # D     #  -  ###  # #
########@ #### ## #@#   ###    #
#@@@@@##@ ##@< ## ### ####  o  #
#@   @###  #   ##     #@#   #< #
#@  M@####   ###|<< #- #  D D  #
#@@@@@####S<###@@   ##         #
################################
0   7
17  17
2   12
3   12
4   29
1   12
24  11
17  23
