Chicken Supreme
################################
#       #!!!@#     # @# @<#@@@!#
# #  !# #@@@@# #@< # !@|<<#  !<#
# | #@< #@#@<# ### # -#  ## !< #
# |  @@ #@@@<# #!!   #    #@<  #
# | #!# #      #!<             #
# | @@!<########@  # #  !<#  |<#
# |  |<-###2   #@  #@#@@<<#@   #
# |     ##!<##-##### ######### #
# #     #@@  #@#@!! !!!!|<<<@# #
#    !< ###  #@-!!@ ---- |<<<# #
#|###!  #@@  ###!-@ ||@|! |<<# #
#|--#@  ####MMM#@  ---|--  |<#@#
###|### ######M###|######|######
#@  !   #@@@                   #
#@<<< !<########################
#@ !< ! #                      #
#|<<  ! # #########     #<<<<< #
##    @@# #      #@# !  #@   ! #
#    ####   #@!#<#   -!<## @ ! #
# !  @@@#####@<#1#    ! #    ! #
# ###########@!# #  @<<<#@#  ! #
#      !#   #@<#<#@@#@@@#@@#@! #
#@##   @# #      ############# #
#@#     # ######## @<#         #
#@# !<< #            # ! #  ! !#
#@# !!  # #<<<<#   !<# @<#  !@!#
#@# !#  @ #|@#|#  !<|# # # ###!#
#@#@@#@@# #@   #@<<###   #|@@@<#
#@####################<<<#|@E@<#
#@                       #|@@@<#
################################
13  17
8   4
13  12
14  13
12  12
14  12
