Explosive Mixture
1000
################################
#@##@M#M  # o#@#! @##   ####! M#
#@##  !#  # !!@#-  #   #x|<#M2 #
# -#o1- !<# !o@#x# #o |<#  #o###
# ####  - # --@#################
# #@ #  o## !-## #!#    #@x  !<#
# #  #o #@# o#@#  -# !@ #@|  -##
# # ####### ####@o # o#####  @##
# # #@#@#   #@!##### -#        #
# # !!@ #     -   E########### #
# # -!# # ##########    #@#### #
# # o!@ # #!    !#   o  ###!@# #
# ##### # ##o  |<#  !#  # |x<# #
#   #@# # #x#   !#  !@< #@ ### #
# ! #|# # ##@#  ## |<   #@   # #
#|#   # # ############# ####<# #
#     # # #@            #x   # #
#@ # @# # ############# #  # # #
##x#x##@#  #  |#      ###  #<# #
##########   !<#@ #<o@#x     # #
####|##@#@   ! #  # !@######## #
#     # #  @<< #    !@# #x     #
#       # ####### ##### #  #<# #
#     ! #               #  # #@#
#------ ################# !!!###
#xxxx## #@#@##          # -o-  #
#######@#@ @#o  #       # o-@ @#
##@!@######@#-    #<!< #########
#@ -##   @#@#x<     #  #|@<@<!<#
#x      |< ###    ###       #@|#
#@    #@##                #    #
################################
3   0
24  0
30  1
28  2
7   1
5   1
